id: hills
title: Hills
description: Cover is natually provided
notes: Developer notes. Testing description This map should provide cover, mostly for assymmetric battles agains units that have a lot of aerial space control
width: 89
height: 35
spawn_zones: [[8, 2, 37, 29]]
enemy_zones: [[49, 2, 82, 29]]
autoFillTerrain: true
autoFillTerrainValues: [2, 5]
data:
.........................................................................................
.........................................................................................
.........................................................................................
....................................................................1....................
....................................................................1....................
......................................1............................11....................
.....................................11...........................111....................
..................11.................111..........................111....................
.................1111................111.........1................111....................
.................1111..............11111........11................111....................
.......11........1111..............11111.......111................111....................
.......111.......1111..............11111.......111..............11111...............1....
.....11111.....111111..............11111.......111.............1111111.............11....
....111111.....111111.........1...111111.......1111............1111111.............11....
....111111.....111111........11...11111........1111............1111111............111....
....1111111....111111.......111...11111........1111...........11111111............111....
...11111111....111111.......111...1111111......1111.........11111111111...........111....
...11111111....1111111......111...11111111....11111.........11111111111..........1111....
..11111111....11111111......11111.11111111....11111.........111111111111........11111....
.1111111111...11111111.....1111111111111111...11111........11111111111111.11....11111....
11111111111...1111111111...1111111111111111...11111.....111111111111111111111...11111....
111111111111..1111111111...11111111111111111..111111....11111111111111111111111.1111111..
111111111111111111111111...11111111111111111111111111...1111111111111111111111111111111..
111111111111111111111111...1111111111111111111111111111111111111111111111111111111111111.
111111111111111111111111...11111111111111111111111111111111111111111111111111111111111111
111111111111111111111111..111111111111111111111111111111111111111111111111111111111111111
1111111111111111111111111.111111111111111111111111111111111111111111111111111111111111111
11111111111111111111111111111111111111111111111111111111111111111111111111111111111111111
11111111111111111111111111111111111111111111111111111111111111111111111111111111111111111
11111111111111111111111111111111111111111111111111111111111111111111111111111111111111111
11111111111111111111111111111111111111111111111111111111111111111111111111111111111111111
11111111111111111111111111111111111111111111111111111111111111111111111111111111111111111
11111111111111111111111111111111111111111111111111111111111111111111111111111111111111111
11111111111111111111111111111111111111111111111111111111111111111111111111111111111111111
11111111111111111111111111111111111111111111111111111111111111111111111111111111111111111
